6 6
0 0 0 0 0 -1
0 5 1 1 0 0
0 3 2 4 1 0
0 1 1 0 1 0
0 1 1 1 1 0
0 0 0 0 0 0
