7 9
0 0 0 0 -1 0 0 0 0
0 1 1 0 0 0 1 1 0
0 1 2 1 4 1 2 1 0
0 1 1 1 3 1 1 1 0
0 0 0 1 3 2 0 0 0
-1 -1 0 5 3 1 0 -1 -1
-1 -1 0 0 0 0 0 -1 -1
