8 6
-1 -1 0 0 0 0
0 0 0 1 5 0
0 1 1 2 1 0
0 1 1 4 3 0
0 1 1 4 3 0
0 1 1 2 1 0
0 0 0 1 1 0
-1 -1 0 0 0 0
